abbauen	SPEAKER
abberufen	AGENT
abbrummen	SPEAKER
abbüßen	SPEAKER
abfertigen	SPEAKER
abflauen	SPEAKER
abhalftern	SPEAKER
abhelfen	SPEAKER
abkanzeln	SPEAKER
abklären	AGENT
abknöpfen	SPEAKER
ablassen	AGENT
ablehnen	AGENT
ableugnen	AGENT
abmachen	AGENT
abmühen	AGENT
abplagen	AGENT
abrackern	SPEAKER
abraten	AGENT
abreagieren	AGENT
abrechnen	AGENT
abrichten	AGENT
abringen	SPEAKER
absacken	SPEAKER
absagen	AGENT
abschalten	SPEAKER
abschieben	AGENT
abschlachten	SPEAKER
abschlaffen	SPEAKER
abschlagen	AGENT
abschließen	AGENT
abschrecken	PATIENT
abschwächen	SPEAKER
abschwellen	SPEAKER
abschwören	AGENT
absegnen	AGENT
absehen	AGENT
absitzen	SPEAKER
absorbieren	SPEAKER
abspeisen	SPEAKER
absprechen	AGENT
absteigen	SPEAKER
absterben	SPEAKER
abstoßen	PATIENT
abstreiten	AGENT
abtöten	AGENT
abtrotzen	SPEAKER
abtun	AGENT
aburteilen	AGENT
abverlangen	SPEAKER
abwählen	AGENT
abwehren	AGENT
abweisen	AGENT
abwerben	AGENT
abwiegeln	SPEAKER
abwimmeln	SPEAKER
abwinken	AGENT
abwürgen	SPEAKER
achten	AGENT
ächten	AGENT
achtgeben	AGENT
ächzen	SPEAKER
ackern	SPEAKER
adeln	SPEAKER
ahnden	AGENT
akklimatisieren	SPEAKER
aktivieren	SPEAKER
akzeptieren	AGENT
alarmieren	PATIENT
albern	SPEAKER
amüsieren	AGENT
anbiedern	SPEAKER
anblaffen	SPEAKER
anblasen	AGENT
anbrüllen	SPEAKER
andeuten	SPEAKER
androhen	AGENT
anekeln	PATIENT
anerkennen	AGENT
anfahren	AGENT
anfauchen	SPEAKER
anfechten	AGENT
anfeuern	PATIENT
anflehen	AGENT
anflunkern	SPEAKER
anfreunden	AGENT
angeben	SPEAKER
angehen	AGENT
angreifen	AGENT
ängsten	AGENT
ängstigen	PATIENT
anhängen	SPEAKER
anherrschen	SPEAKER
animieren	PATIENT
anklagen	AGENT
anknacksen	SPEAKER
anknurren	SPEAKER
ankreiden	AGENT
anlabern	SPEAKER
anlasten	AGENT
anlügen	SPEAKER
anmachen	SPEAKER
anmahnen	AGENT
anmaßen	SPEAKER
annehmen	AGENT
anöden	PATIENT
anordnen	AGENT
anpassen	SPEAKER
anpöbeln	SPEAKER
anprangern	AGENT
anpreisen	AGENT
anquatschen	SPEAKER
anregen	PATIENT
anreizen	PATIENT
anrühren	PATIENT
anschmieren	SPEAKER
anschnauzen	SPEAKER
anschreien	SPEAKER
anschuldigen	AGENT
anschwärzen	SPEAKER
anspornen	PATIENT
anspucken	AGENT
anstacheln	SPEAKER
anstecken	SPEAKER
anstellen	SPEAKER
anstrengen	AGENT
antreiben	SPEAKER
anturnen	PATIENT
anvertrauen	AGENT
anwidern	PATIENT
anzeigen	AGENT
anziehen	PATIENT
anzischen	SPEAKER
anzweifeln	AGENT
ärgern	PATIENT
argwöhnen	AGENT
arrangieren	AGENT
ästhetisieren	SPEAKER
ästimieren	AGENT
attackieren	SPEAKER
attestieren	AGENT
aufarbeiten	AGENT
aufbauschen	SPEAKER
aufbegehren	AGENT
aufblähen	SPEAKER
aufblühen	SPEAKER
aufdrängen	SPEAKER
auffressen	SPEAKER
aufgeben	AGENT
aufheitern	PATIENT
aufhetzen	SPEAKER
aufhören	AGENT
aufklären	SPEAKER
auflachen	AGENT
auflehnen	AGENT
aufmucken	SPEAKER
aufmuntern	PATIENT
aufnötigen	SPEAKER
aufopfern	AGENT
aufpeitschen	SPEAKER
aufputschen	SPEAKER
aufraffen	AGENT
aufregen	PATIENT
aufreiben	SPEAKER
aufrütteln	PATIENT
aufstacheln	SPEAKER
aufsteigen	SPEAKER
aufweisen	SPEAKER
aufwühlen	PATIENT
aufziehen	PATIENT
aufzwingen	SPEAKER
ausbaden	SPEAKER
ausbauen	AGENT
ausbedingen	AGENT
ausbitten	AGENT
ausbluten	SPEAKER
ausbrennen	SPEAKER
ausbrüten	SPEAKER
ausbügeln	SPEAKER
ausbuhen	AGENT
auseinanderdriften	SPEAKER
auseinanderleben	SPEAKER
ausflippen	SPEAKER
ausfragen	SPEAKER
ausgrenzen	SPEAKER
aushalten	AGENT
ausharren	AGENT
ausheulen	SPEAKER
aushöhlen	SPEAKER
aushorchen	SPEAKER
auskommen	AGENT
auskotzen	SPEAKER
auskugeln	AGENT
auslachen	AGENT
auslaugen	SPEAKER
ausmachen	PATIENT
ausmustern	AGENT
auspacken	SPEAKER
auspfeifen	AGENT
auspowern	PATIENT
ausquetschen	SPEAKER
ausrasten	SPEAKER
ausreizen	SPEAKER
ausrenken	SPEAKER
ausruhen	AGENT
ausschelten	AGENT
ausschimpfen	AGENT
ausschlafen	AGENT
ausschließen	AGENT
ausschöpfen	SPEAKER
aussitzen	SPEAKER
aussöhnen	PATIENT
ausspannen	SPEAKER
aussperren	AGENT
ausspielen	SPEAKER
ausspucken	SPEAKER
ausstoßen	AGENT
austricksen	SPEAKER
ausweinen	AGENT
ausweisen	AGENT
auszanken	AGENT
auszehren	SPEAKER
auszeichnen	AGENT
autorisieren	AGENT
avancieren	SPEAKER
bagatellisieren	SPEAKER
bändigen	SPEAKER
bangen	AGENT
bannen	PATIENT
beanspruchen	AGENT
beanstanden	AGENT
bebrüten	SPEAKER
becircen	SPEAKER
bedanken	AGENT
bedauern	AGENT
bedeuten	SPEAKER
bedrängen	SPEAKER
bedrohen	SPEAKER
beehren	SPEAKER
beeiden	AGENT
beeindrucken	PATIENT
beeinflussen	SPEAKER
beeinträchtigen	SPEAKER
beenden	AGENT
befähigen	SPEAKER
befallen	SPEAKER
befehligen	SPEAKER
beflügeln	PATIENT
befördern	AGENT
befremden	PATIENT
befrieden	SPEAKER
befriedigen	PATIENT
befruchten	SPEAKER
befürchten	AGENT
befürworten	AGENT
begehen	AGENT
begehren	AGENT
begeistern	PATIENT
beglücken	PATIENT
beglückwünschen	AGENT
begnügen	AGENT
begründen	AGENT
begrüßen	AGENT
begünstigen	SPEAKER
begutachten	AGENT
begütigen	PATIENT
beharren	AGENT
beherrschen	SPEAKER
behexen	SPEAKER
beibehalten	AGENT
beichten	AGENT
beißen	SPEAKER
bejahen	AGENT
bejammern	SPEAKER
bejubeln	AGENT
bekehren	PATIENT
bekennen	AGENT
beklagen	AGENT
beklatschen	AGENT
beknien	SPEAKER
bekräftigen	AGENT
belabern	SPEAKER
belächeln	AGENT
belachen	AGENT
belangen	AGENT
belasten	PATIENT
belästigen	SPEAKER
beleben	SPEAKER
belegen	AGENT
beleidigen	PATIENT
belobigen	AGENT
belügen	SPEAKER
belustigen	PATIENT
bemängeln	AGENT
bemänteln	SPEAKER
bemitleiden	AGENT
bemühen	AGENT
bemuttern	SPEAKER
benachteiligen	SPEAKER
beneiden	AGENT
berappeln	SPEAKER
berechtigen	SPEAKER
bereinigen	SPEAKER
bereuen	AGENT
berichtigen	AGENT
beruhigen	PATIENT
berühren	PATIENT
besänftigen	PATIENT
bescheiden	AGENT
bescheinigen	AGENT
bescheißen	SPEAKER
beschimpfen	AGENT
beschließen	AGENT
beschönigen	SPEAKER
beschuldigen	AGENT
beschweren	AGENT
beschwichtigen	PATIENT
beschwören	AGENT
beseelen	PATIENT
beseligen	PATIENT
besiegen	PATIENT
bespucken	AGENT
bessern	SPEAKER
bestärken	PATIENT
bestätigen	AGENT
bestechen	SPEAKER
bestehen	SPEAKER
bestrafen	AGENT
bestreiten	AGENT
bestürzen	PATIENT
beten	AGENT
beteuern	AGENT
betören	PATIENT
betrauern	AGENT
betrüben	PATIENT
betrügen	SPEAKER
betteln	SPEAKER
beunruhigen	PATIENT
beurlauben	AGENT
bevormunden	SPEAKER
bevorrechtigen	SPEAKER
bevorzugen	AGENT
bewahrheiten	SPEAKER
bewältigen	SPEAKER
bewegen	PATIENT
beweinen	AGENT
beweisen	SPEAKER
bewilligen	AGENT
bewirken	SPEAKER
bewundern	AGENT
bezahlen	SPEAKER
bezähmen	SPEAKER
bezaubern	PATIENT
bezeigen	AGENT
bezichtigen	SPEAKER
bezirzen	SPEAKER
bezuschussen	AGENT
bezweifeln	AGENT
bibbern	SPEAKER
billigen	AGENT
bitten	AGENT
blamieren	SPEAKER
bläuen	SPEAKER
bleiben	AGENT
blenden	SPEAKER
blessieren	PATIENT
blocken	AGENT
blockieren	SPEAKER
blödeln	SPEAKER
bloßstellen	SPEAKER
bluffen	SPEAKER
bohren	SPEAKER
bölken	SPEAKER
boykottieren	AGENT
brandmarken	SPEAKER
brennen	SPEAKER
brillieren	SPEAKER
brüllen	SPEAKER
brummeln	SPEAKER
brummen	SPEAKER
brüskieren	SPEAKER
brüten	SPEAKER
bürgen	AGENT
büßen	SPEAKER
canceln	AGENT
dagegenhalten	AGENT
dagegenstellen	AGENT
dagegenstemmen	AGENT
dahinleben	SPEAKER
dahinsiechen	SPEAKER
dämonisieren	SPEAKER
danebenliegen	SPEAKER
danken	AGENT
darben	AGENT
dauern	SPEAKER
davonjagen	AGENT
degradieren	AGENT
deichseln	SPEAKER
dekodieren	SPEAKER
dekorieren	SPEAKER
delirieren	SPEAKER
dementieren	AGENT
demoralisieren	PATIENT
demotivieren	PATIENT
demütigen	SPEAKER
denunzieren	SPEAKER
deprimieren	PATIENT
desavouieren	AGENT
desillusionieren	PATIENT
desinfizieren	AGENT
diffamieren	SPEAKER
diskriminieren	SPEAKER
disqualifizieren	AGENT
disziplinieren	SPEAKER
domestizieren	SPEAKER
dominieren	SPEAKER
dorren	SPEAKER
dramatisieren	SPEAKER
drängeln	SPEAKER
drängen	SPEAKER
drangsalieren	SPEAKER
dressieren	SPEAKER
dringen	AGENT
drohen	AGENT
drücken	SPEAKER
dulden	AGENT
düpieren	SPEAKER
durchdrehen	SPEAKER
durcheinanderbringen	SPEAKER
durchfallen	AGENT
durchhalten	AGENT
durchkreuzen	SPEAKER
durchleiden	AGENT
durchmachen	AGENT
durchstehen	AGENT
durchziehen	SPEAKER
dursten	AGENT
dürsten	AGENT
ehren	AGENT
einbeziehen	AGENT
einbilden	SPEAKER
einbimsen	SPEAKER
einbläuen	SPEAKER
eindämmen	SPEAKER
einfordern	AGENT
einfügen	SPEAKER
eingestehen	AGENT
einhämmern	SPEAKER
einimpfen	SPEAKER
einladen	AGENT
einlenken	AGENT
einlullen	SPEAKER
einnehmen	PATIENT
einräumen	AGENT
einreden	SPEAKER
einschläfern	SPEAKER
einschleimen	SPEAKER
einschmeicheln	SPEAKER
einschüchtern	PATIENT
einsitzen	SPEAKER
einstecken	SPEAKER
einstehen	AGENT
eintrichtern	SPEAKER
einweihen	AGENT
einwenden	AGENT
einwerfen	AGENT
einwickeln	SPEAKER
ekeln	AGENT
emanzipieren	AGENT
empfehlen	AGENT
empören	AGENT
engagieren	AGENT
entbrennen	SPEAKER
entdecken	AGENT
entfallen	PATIENT
entfernen	AGENT
entflammen	SPEAKER
entfremden	SPEAKER
entgegenhalten	AGENT
entgegenkommen	AGENT
entgegenstellen	AGENT
entgegentreten	AGENT
entgleisen	SPEAKER
entheben	AGENT
entheiligen	SPEAKER
enthüllen	SPEAKER
entkriminalisieren	SPEAKER
entlassen	AGENT
entlasten	SPEAKER
entmannen	PATIENT
entmutigen	PATIENT
entraten	SPEAKER
enträtseln	AGENT
entrüsten	AGENT
entsagen	AGENT
entschädigen	PATIENT
entschlüsseln	SPEAKER
entschuldigen	AGENT
entschwinden	SPEAKER
entsetzen	PATIENT
entspannen	AGENT
enttäuschen	PATIENT
entweihen	SPEAKER
entwirren	SPEAKER
entwürdigen	SPEAKER
entzücken	PATIENT
entzünden	SPEAKER
erbarmen	AGENT
erbeben	AGENT
erbitten	AGENT
erbittern	PATIENT
erblinden	AGENT
erbosen	PATIENT
erdichten	SPEAKER
erdreisten	SPEAKER
erdulden	AGENT
erfinden	SPEAKER
erflehen	AGENT
erfordern	SPEAKER
erfrechen	SPEAKER
erfreuen	PATIENT
erfrieren	SPEAKER
ergötzen	PATIENT
erheitern	PATIENT
erhellen	SPEAKER
erhöhen	SPEAKER
erholen	AGENT
erkälten	AGENT
erkranken	AGENT
erkühnen	SPEAKER
erlahmen	AGENT
erlauben	AGENT
erleichtern	SPEAKER
erleiden	AGENT
erliegen	SPEAKER
ermahnen	AGENT
ermatten	AGENT
ermüden	PATIENT
ermuntern	PATIENT
ermutigen	PATIENT
ernennen	AGENT
erniedrigen	SPEAKER
ernüchtern	PATIENT
erobern	AGENT
erpressen	SPEAKER
erregen	PATIENT
ersaufen	SPEAKER
erschlaffen	SPEAKER
erschöpfen	SPEAKER
erschrecken	AGENT
erschüttern	SPEAKER
ersehnen	AGENT
erstaunen	PATIENT
ersticken	AGENT
erstreben	AGENT
ersuchen	AGENT
ertauben	AGENT
ertragen	AGENT
ertrinken	AGENT
erwärmen	SPEAKER
erweisen	SPEAKER
erzielen	SPEAKER
erzürnen	PATIENT
erzwingen	SPEAKER
euphorisieren	SPEAKER
exaltieren	SPEAKER
exkommunizieren	AGENT
exkulpieren	SPEAKER
explodieren	SPEAKER
fabulieren	SPEAKER
fackeln	SPEAKER
fallenlassen	SPEAKER
falsifizieren	AGENT
fanatisieren	SPEAKER
fantasieren	SPEAKER
faseln	SPEAKER
faszinieren	PATIENT
favorisieren	AGENT
fehlen	SPEAKER
fehlinterpretieren	SPEAKER
fehlschlagen	SPEAKER
feiern	AGENT
feilhalten	AGENT
feixen	SPEAKER
fernhalten	AGENT
fertigbringen	SPEAKER
fertigmachen	SPEAKER
fesseln	PATIENT
festlegen	AGENT
fetischisieren	SPEAKER
feuern	SPEAKER
fingieren	SPEAKER
flehen	AGENT
flennen	SPEAKER
fluchen	AGENT
flunkern	SPEAKER
folgen	SPEAKER
foppen	SPEAKER
fördern	SPEAKER
fortjagen	SPEAKER
fortschicken	AGENT
frappieren	PATIENT
freien	AGENT
freigeben	AGENT
freisprechen	AGENT
fremdeln	SPEAKER
fremdgehen	SPEAKER
freuen	AGENT
frieren	AGENT
frohlocken	AGENT
frösteln	AGENT
frotzeln	SPEAKER
frustrieren	PATIENT
fügen	SPEAKER
fürchten	AGENT
gängeln	SPEAKER
garantieren	AGENT
gebärden	SPEAKER
gebieten	SPEAKER
gedeihen	SPEAKER
gedenken	AGENT
gedulden	AGENT
gefährden	SPEAKER
gegenübertreten	AGENT
gehorchen	SPEAKER
geißeln	SPEAKER
geloben	AGENT
gelüsten	PATIENT
genehmigen	AGENT
genesen	AGENT
genieren	AGENT
genießen	AGENT
geringschätzen	SPEAKER
germanisieren	SPEAKER
gestatten	AGENT
gestehen	AGENT
gesunden	AGENT
getrauen	AGENT
gettoisieren	SPEAKER
gewähren	AGENT
gewährleisten	AGENT
gewinnen	SPEAKER
gieren	SPEAKER
giften	SPEAKER
glänzen	SPEAKER
glorifizieren	SPEAKER
göbeln	SPEAKER
gönnen	AGENT
goutieren	AGENT
grämen	PATIENT
granteln	SPEAKER
gratulieren	AGENT
grauen	PATIENT
grausen	PATIENT
greinen	SPEAKER
grimassieren	SPEAKER
grinsen	SPEAKER
grölen	SPEAKER
grollen	AGENT
grübeln	SPEAKER
grummeln	SPEAKER
gruseln	PATIENT
gutheißen	AGENT
habilitieren	AGENT
haften	SPEAKER
halluzinieren	SPEAKER
hänseln	SPEAKER
harmonisieren	SPEAKER
hassen	AGENT
hätscheln	SPEAKER
haushalten	SPEAKER
heimsuchen	SPEAKER
heimzahlen	AGENT
heischen	SPEAKER
helfen	SPEAKER
herabsehen	SPEAKER
herabsetzen	SPEAKER
herabstufen	AGENT
herabwürdigen	SPEAKER
herbeiwünschen	AGENT
herbeizitieren	SPEAKER
hereinlegen	SPEAKER
heroisieren	SPEAKER
herrschen	SPEAKER
herumfuhrwerken	SPEAKER
herumhacken	SPEAKER
herumhuren	SPEAKER
herumtreiben	SPEAKER
heruntermachen	SPEAKER
herunterspielen	SPEAKER
herunterstufen	AGENT
herziehen	SPEAKER
herzitieren	SPEAKER
heucheln	SPEAKER
heulen	SPEAKER
hinausschmeißen	SPEAKER
hinauswagen	AGENT
hinauswerfen	SPEAKER
hindern	SPEAKER
hineinknien	SPEAKER
hinnehmen	AGENT
hintanstellen	AGENT
hinterfragen	AGENT
hintergehen	SPEAKER
hintertreiben	SPEAKER
hinwegsehen	AGENT
hinwegsetzen	SPEAKER
hinwegtäuschen	SPEAKER
hochachten	AGENT
hochstilisieren	SPEAKER
hoffen	AGENT
hofieren	SPEAKER
höhnen	SPEAKER
honorieren	AGENT
hudeln	SPEAKER
huldigen	AGENT
hungern	AGENT
huren	SPEAKER
hüten	AGENT
idealisieren	SPEAKER
ignorieren	AGENT
indizieren	SPEAKER
infizieren	SPEAKER
insistieren	AGENT
inspirieren	PATIENT
inszenieren	SPEAKER
integrieren	SPEAKER
interessieren	AGENT
intrigieren	SPEAKER
ironisieren	AGENT
irren	SPEAKER
jammern	SPEAKER
jauchzen	AGENT
jubeln	AGENT
jubilieren	SPEAKER
kaltstellen	SPEAKER
kapitulieren	AGENT
kaprizieren	SPEAKER
kaputtgehen	SPEAKER
karikieren	SPEAKER
kastrieren	SPEAKER
keifen	SPEAKER
keuchen	SPEAKER
kichern	SPEAKER
kläffen	SPEAKER
klagen	AGENT
klären	SPEAKER
klarlegen	AGENT
klarstellen	AGENT
klatschen	SPEAKER
klotzen	SPEAKER
kokettieren	SPEAKER
kollabieren	AGENT
kompromittieren	SPEAKER
konspirieren	SPEAKER
konsternieren	PATIENT
konterkarieren	SPEAKER
kontrollieren	AGENT
korrigieren	SPEAKER
korrumpieren	SPEAKER
kotzen	SPEAKER
krakeelen	SPEAKER
kränkeln	SPEAKER
kranken	SPEAKER
kränken	PATIENT
krebsen	SPEAKER
kriechen	SPEAKER
kriminalisieren	SPEAKER
kritisieren	AGENT
krümmen	AGENT
krummnehmen	AGENT
kujonieren	SPEAKER
kümmern	AGENT
kündigen	AGENT
kungeln	SPEAKER
küren	AGENT
kuschen	SPEAKER
labern	SPEAKER
lächeln	AGENT
lachen	AGENT
lädieren	SPEAKER
lähmen	PATIENT
lamentieren	SPEAKER
langweilen	PATIENT
lasten	PATIENT
lästern	SPEAKER
läutern	SPEAKER
lechzen	AGENT
legalisieren	AGENT
legitimieren	AGENT
leiden	AGENT
leimen	SPEAKER
leugnen	AGENT
liebäugeln	SPEAKER
lieben	AGENT
liebhaben	AGENT
linken	SPEAKER
loben	AGENT
lobpreisen	AGENT
losbrüllen	SPEAKER
loslachen	SPEAKER
lossagen	AGENT
lossprechen	AGENT
lügen	SPEAKER
mahnen	AGENT
mäkeln	SPEAKER
malträtieren	SPEAKER
marginalisieren	SPEAKER
markieren	SPEAKER
martern	PATIENT
mäßigen	SPEAKER
maßregeln	AGENT
maulen	SPEAKER
mauscheln	SPEAKER
meckern	SPEAKER
metastasieren	SPEAKER
meutern	AGENT
missionieren	AGENT
mitbestimmen	AGENT
mitentscheiden	AGENT
mitfühlen	AGENT
mithelfen	SPEAKER
mitreißen	PATIENT
mittragen	AGENT
mobben	SPEAKER
mogeln	SPEAKER
mögen	AGENT
monieren	AGENT
mopsen	SPEAKER
moralisieren	SPEAKER
motivieren	PATIENT
mucken	SPEAKER
mühen	AGENT
murren	SPEAKER
mythologisieren	SPEAKER
nacheifern	AGENT
nachempfinden	AGENT
nachgeben	AGENT
nachgrübeln	SPEAKER
nachhaken	SPEAKER
nachhelfen	SPEAKER
nachkarten	SPEAKER
nachsagen	SPEAKER
nachtragen	AGENT
nachtrauern	AGENT
nachweinen	AGENT
nachweisen	AGENT
nahebringen	PATIENT
narren	PATIENT
necken	SPEAKER
negieren	AGENT
neiden	AGENT
neppen	SPEAKER
nerven	SPEAKER
niederdrücken	PATIENT
niederhalten	SPEAKER
nobilitieren	SPEAKER
nölen	SPEAKER
nörgeln	SPEAKER
normalisieren	SPEAKER
nötigen	SPEAKER
nutzen	AGENT
nützen	SPEAKER
öden	PATIENT
offenbaren	AGENT
opfern	AGENT
opponieren	AGENT
paralysieren	SPEAKER
parodieren	SPEAKER
peinigen	PATIENT
perfektionieren	SPEAKER
persiflieren	SPEAKER
petzen	SPEAKER
pfeifen	SPEAKER
pflegen	AGENT
phantasieren	SPEAKER
piesacken	SPEAKER
plädieren	AGENT
plagen	PATIENT
plärren	SPEAKER
pochen	AGENT
polemisieren	SPEAKER
poltern	SPEAKER
präferieren	AGENT
prägen	SPEAKER
prämieren	AGENT
präzisieren	SPEAKER
preisen	AGENT
preisgeben	SPEAKER
prellen	SPEAKER
priorisieren	AGENT
privilegieren	SPEAKER
profitieren	SPEAKER
promovieren	AGENT
propagieren	AGENT
protegieren	SPEAKER
protestieren	AGENT
prozessieren	AGENT
quälen	PATIENT
quengeln	SPEAKER
querlegen	SPEAKER
querstellen	SPEAKER
quetschen	SPEAKER
quittieren	AGENT
rächen	AGENT
rackern	SPEAKER
ramponieren	SPEAKER
rationalisieren	SPEAKER
rausekeln	SPEAKER
rausfeuern	SPEAKER
rausschmeißen	SPEAKER
rauswerfen	SPEAKER
realisieren	SPEAKER
rebellieren	AGENT
rechtfertigen	AGENT
reflektieren	AGENT
reformieren	SPEAKER
regenerieren	SPEAKER
rehabilitieren	SPEAKER
reihern	SPEAKER
reinhauen	SPEAKER
reinigen	SPEAKER
reklamieren	AGENT
relaxen	AGENT
resignieren	AGENT
respektieren	AGENT
retten	SPEAKER
reuen	PATIENT
revanchieren	AGENT
revidieren	AGENT
richtigstellen	AGENT
riskieren	SPEAKER
ritualisieren	SPEAKER
romantisieren	SPEAKER
rüffeln	SPEAKER
rügen	AGENT
rühmen	AGENT
rühren	PATIENT
ruinieren	SPEAKER
runtermachen	SPEAKER
runterputzen	SPEAKER
sabotieren	SPEAKER
sacken	SPEAKER
salben	AGENT
sanktionieren	AGENT
schaden	SPEAKER
schädigen	SPEAKER
schämen	AGENT
schänden	SPEAKER
schassen	SPEAKER
schätzen	AGENT
schaudern	PATIENT
schaukeln	SPEAKER
schäumen	SPEAKER
scheiden	SPEAKER
scheitern	SPEAKER
schelten	AGENT
scherzen	AGENT
scheuen	AGENT
schiefliegen	SPEAKER
schikanieren	SPEAKER
schimpfen	AGENT
schinden	SPEAKER
schlechtmachen	SPEAKER
schlechtreden	SPEAKER
schleifen	SPEAKER
schluchzen	AGENT
schmachten	SPEAKER
schmähen	SPEAKER
schmarotzen	SPEAKER
schmeicheln	SPEAKER
schmerzen	PATIENT
schmollen	SPEAKER
schmunzeln	AGENT
schnüffeln	SPEAKER
schocken	PATIENT
schockieren	PATIENT
schonen	AGENT
schönreden	SPEAKER
schrecken	PATIENT
schreien	SPEAKER
schuften	SPEAKER
schulmeistern	SPEAKER
schummeln	SPEAKER
schurigeln	SPEAKER
schützen	AGENT
schwänzen	SPEAKER
schwärmen	SPEAKER
schwarzarbeiten	SPEAKER
schwarzmalen	SPEAKER
schwarzsehen	SPEAKER
schwindeln	SPEAKER
schwören	AGENT
sehnen	AGENT
sensibilisieren	PATIENT
seufzen	AGENT
sichern	SPEAKER
simulieren	SPEAKER
sinnieren	SPEAKER
sitzenbleiben	SPEAKER
solidarisieren	AGENT
sonnen	SPEAKER
sorgen	AGENT
spaßen	AGENT
speien	SPEAKER
sperren	AGENT
spinnen	SPEAKER
spintisieren	SPEAKER
spionieren	SPEAKER
sponsern	AGENT
spotten	SPEAKER
spucken	SPEAKER
standardisieren	SPEAKER
standhalten	SPEAKER
stänkern	SPEAKER
staunen	AGENT
stechen	PATIENT
steigern	SPEAKER
steuern	SPEAKER
sticheln	SPEAKER
stigmatisieren	SPEAKER
stinken	SPEAKER
stöhnen	AGENT
strafen	AGENT
strapazieren	SPEAKER
sträuben	SPEAKER
streiten	AGENT
stressen	PATIENT
streuen	SPEAKER
stürzen	SPEAKER
subjektivieren	SPEAKER
sublimieren	SPEAKER
suggerieren	SPEAKER
sühnen	SPEAKER
suspendieren	AGENT
sympathisieren	AGENT
tabuisieren	SPEAKER
tadeln	AGENT
täuschen	SPEAKER
terrorisieren	SPEAKER
testieren	AGENT
tiefstapeln	SPEAKER
toben	SPEAKER
tolerieren	AGENT
töten	SPEAKER
totschweigen	SPEAKER
trainieren	AGENT
traktieren	SPEAKER
tratschen	SPEAKER
trauen	AGENT
trauern	AGENT
traumatisieren	PATIENT
trennen	AGENT
tricksen	SPEAKER
triezen	SPEAKER
triumphieren	AGENT
trösten	PATIENT
trotzen	AGENT
typisieren	SPEAKER
tyrannisieren	SPEAKER
übelnehmen	AGENT
überanstrengen	SPEAKER
überarbeiten	SPEAKER
überbeanspruchen	SPEAKER
überbelasten	SPEAKER
überdehnen	SPEAKER
übereinkommen	AGENT
überfallen	SPEAKER
überfordern	SPEAKER
übergehen	AGENT
überlasten	SPEAKER
überordnen	AGENT
überraschen	PATIENT
überreagieren	SPEAKER
überreden	PATIENT
überschätzen	SPEAKER
überschnappen	SPEAKER
überschreiten	SPEAKER
überstrapazieren	SPEAKER
übertölpeln	SPEAKER
übertreiben	SPEAKER
übertreten	SPEAKER
übervorteilen	SPEAKER
überwältigen	PATIENT
überwinden	PATIENT
überzeugen	PATIENT
umbringen	SPEAKER
umfallen	SPEAKER
umgarnen	SPEAKER
umgestalten	AGENT
umkommen	SPEAKER
umschmeicheln	SPEAKER
umsorgen	SPEAKER
umstimmen	PATIENT
umwerben	SPEAKER
umwerfen	SPEAKER
unterbinden	SPEAKER
unterdrücken	SPEAKER
unterhalten	PATIENT
unterjubeln	SPEAKER
unterlegen	SPEAKER
unterliegen	AGENT
unterminieren	SPEAKER
unterordnen	AGENT
untersagen	AGENT
unterschätzen	SPEAKER
unterschieben	SPEAKER
unterschlagen	SPEAKER
unterstellen	SPEAKER
unterstützen	AGENT
untertreiben	SPEAKER
unterwerfen	AGENT
vegetieren	SPEAKER
verabreden	AGENT
verabscheuen	AGENT
verachten	AGENT
veralbern	SPEAKER
veranlassen	AGENT
verantworten	AGENT
veräppeln	SPEAKER
verargen	AGENT
verärgern	PATIENT
verarmen	SPEAKER
verarschen	SPEAKER
verausgaben	SPEAKER
verballhornen	SPEAKER
verbannen	AGENT
verbeißen	SPEAKER
verbessern	SPEAKER
verbieten	AGENT
verblüffen	PATIENT
verbluten	AGENT
verbrämen	SPEAKER
verbrennen	AGENT
verbriefen	AGENT
verbrüdern	SPEAKER
verbrühen	AGENT
verbuchen	SPEAKER
verbummeln	SPEAKER
verbünden	AGENT
verbürgen	AGENT
verbüßen	SPEAKER
verdächtigen	AGENT
verdammen	AGENT
verdauen	SPEAKER
verderben	SPEAKER
verdeutlichen	SPEAKER
verdonnern	SPEAKER
verdorren	SPEAKER
verdrängen	SPEAKER
verdrehen	SPEAKER
verdrießen	PATIENT
verdursten	AGENT
verehren	AGENT
vereiteln	SPEAKER
verelenden	SPEAKER
verenden	SPEAKER
verfallen	SPEAKER
verfälschen	SPEAKER
verfehlen	SPEAKER
verfluchen	AGENT
verfolgen	SPEAKER
verführen	SPEAKER
vergällen	PATIENT
vergammeln	SPEAKER
vergeben	AGENT
vergehen	SPEAKER
vergelten	AGENT
vergessen	AGENT
vergewaltigen	SPEAKER
vergießen	SPEAKER
vergnügen	AGENT
vergönnen	AGENT
vergotten	SPEAKER
vergöttern	SPEAKER
vergöttlichen	SPEAKER
vergrätzen	SPEAKER
vergraulen	SPEAKER
verhalten	SPEAKER
verharmlosen	SPEAKER
verhätscheln	SPEAKER
verhehlen	SPEAKER
verheimlichen	SPEAKER
verheißen	AGENT
verhelfen	SPEAKER
verherrlichen	SPEAKER
verhexen	SPEAKER
verhindern	SPEAKER
verhohnepipeln	SPEAKER
verhören	AGENT
verhungern	AGENT
verifizieren	AGENT
verkalkulieren	SPEAKER
verkennen	SPEAKER
verklagen	AGENT
verklären	SPEAKER
verklausulieren	SPEAKER
verknacken	SPEAKER
verkneifen	SPEAKER
verknusen	SPEAKER
verkohlen	SPEAKER
verkommen	SPEAKER
verkraften	SPEAKER
verkühlen	AGENT
verkümmern	SPEAKER
verlachen	SPEAKER
verladen	SPEAKER
verlangen	AGENT
verleiden	PATIENT
verlernen	AGENT
verletzen	PATIENT
verleumden	SPEAKER
verlieben	AGENT
verlieren	AGENT
verlocken	PATIENT
verlottern	SPEAKER
vermaledeien	AGENT
vermasseln	SPEAKER
vermiesen	SPEAKER
vermindern	SPEAKER
vermitteln	AGENT
vernachlässigen	SPEAKER
vernehmen	AGENT
verneinen	AGENT
verniedlichen	SPEAKER
veröden	SPEAKER
verpassen	SPEAKER
verpennen	SPEAKER
verpetzen	SPEAKER
verpfeifen	SPEAKER
verpflichten	SPEAKER
verprellen	PATIENT
verraten	SPEAKER
versagen	SPEAKER
versauen	SPEAKER
versäumen	SPEAKER
verschätzen	SPEAKER
verschaukeln	SPEAKER
verscheiden	SPEAKER
verscheißern	SPEAKER
verschießen	SPEAKER
verschlafen	SPEAKER
verschlagen	SPEAKER
verschlechtern	SPEAKER
verschließen	SPEAKER
verschmähen	AGENT
verschrecken	PATIENT
verschweigen	SPEAKER
verschwitzen	SPEAKER
verschwören	SPEAKER
versehren	PATIENT
versetzen	AGENT
versichern	AGENT
versieben	SPEAKER
versklaven	SPEAKER
verslumen	SPEAKER
versöhnen	AGENT
verspäten	SPEAKER
versprechen	AGENT
verständigen	AGENT
verstauchen	AGENT
versteifen	SPEAKER
versterben	SPEAKER
verstimmen	SPEAKER
verstören	PATIENT
verstoßen	SPEAKER
verstümmeln	SPEAKER
versumpfen	SPEAKER
versüßen	SPEAKER
vertauschen	SPEAKER
verteidigen	AGENT
verteufeln	SPEAKER
vertragen	AGENT
vertrocknen	SPEAKER
vertrösten	AGENT
verübeln	AGENT
verüben	SPEAKER
verunglimpfen	SPEAKER
verunklaren	SPEAKER
verunmöglichen	SPEAKER
verurteilen	AGENT
vervollkommnen	SPEAKER
verwahrlosen	SPEAKER
verwaisen	SPEAKER
verwarnen	AGENT
verwechseln	SPEAKER
verwehren	AGENT
verweigern	AGENT
verwerfen	AGENT
verwesen	SPEAKER
verwestlichen	SPEAKER
verwirklichen	SPEAKER
verwirren	PATIENT
verwöhnen	SPEAKER
verwunden	PATIENT
verwundern	PATIENT
verwünschen	AGENT
verzagen	AGENT
verzärteln	SPEAKER
verzaubern	PATIENT
verzeihen	AGENT
verzichten	AGENT
verziehen	SPEAKER
verzücken	PATIENT
verzweifeln	AGENT
vorarbeiten	SPEAKER
vorbauen	AGENT
vorbehalten	AGENT
vorbeugen	AGENT
vorenthalten	SPEAKER
vorflunkern	SPEAKER
vorgaukeln	SPEAKER
vorgeben	SPEAKER
vorheucheln	SPEAKER
vorknöpfen	SPEAKER
vorliebnehmen	AGENT
vorlügen	SPEAKER
vormachen	SPEAKER
vornehmen	AGENT
vorschieben	SPEAKER
vorschreiben	AGENT
vorschützen	SPEAKER
vorschwindeln	SPEAKER
vorsorgen	AGENT
vorspiegeln	SPEAKER
vorspielen	SPEAKER
vortäuschen	SPEAKER
vorverurteilen	SPEAKER
vorwagen	AGENT
vorwerfen	AGENT
vorziehen	AGENT
wagen	AGENT
warnen	AGENT
wegekeln	SPEAKER
wegschicken	AGENT
wegstecken	SPEAKER
wegwünschen	AGENT
wehklagen	AGENT
wehren	AGENT
weichen	AGENT
weigern	AGENT
weihen	AGENT
weinen	AGENT
weismachen	SPEAKER
wertschätzen	AGENT
wettern	SPEAKER
wettmachen	SPEAKER
widerlegen	AGENT
widerrufen	AGENT
widersetzen	AGENT
widersprechen	AGENT
widerstehen	AGENT
widerstreben	PATIENT
widmen	AGENT
wimmern	SPEAKER
winseln	SPEAKER
wohltun	PATIENT
wollen	AGENT
wünschen	AGENT
würdigen	AGENT
wurmen	SPEAKER
wüten	SPEAKER
zagen	AGENT
zähmen	SPEAKER
zaudern	AGENT
zeigen	AGENT
zeihen	AGENT
zelebrieren	SPEAKER
zerfallen	SPEAKER
zermürben	SPEAKER
zerrütten	SPEAKER
zerschrammen	SPEAKER
zersetzen	SPEAKER
zetern	SPEAKER
zicken	SPEAKER
zieren	SPEAKER
zitieren	SPEAKER
zittern	AGENT
zivilisieren	SPEAKER
zögern	AGENT
zollen	AGENT
zubilligen	AGENT
zufriedengeben	AGENT
zufriedenstellen	PATIENT
zufügen	SPEAKER
zugeben	AGENT
zügeln	SPEAKER
zugestehen	AGENT
zulassen	AGENT
zuraten	AGENT
zurechtstutzen	AGENT
zurechtweisen	AGENT
zürnen	AGENT
zurückfordern	AGENT
zurückhalten	AGENT
zurückscheuen	AGENT
zurückschrecken	PATIENT
zurückstecken	AGENT
zurücktreten	AGENT
zurückverlangen	AGENT
zurückweisen	AGENT
zurückwünschen	AGENT
zusagen	AGENT
zusammenbrechen	SPEAKER
zusammenkrümmen	AGENT
zusammennehmen	SPEAKER
zusammenreißen	SPEAKER
zusammenrotten	SPEAKER
zusammenstauchen	SPEAKER
zusetzen	SPEAKER
zusichern	AGENT
zustimmen	AGENT
zutrauen	AGENT
zuwiderhandeln	SPEAKER
zweifeln	AGENT
zwingen	SPEAKER
